11111111111111
11000000P00011
1ECCCC00000001
11111111111111
